27
17

XXXXXXXXXXXXXXXXXXXXXXXXXXX
XJJJJJJJJJJJJJJJJJJJJJBX41X
XJXXJXJXXXXXXXXXXXXXJXJX2VX
XJJJBXJJJJJJJJJJJJJJJXJXXVX
XJXXXXJXXXJXXXXXJXXXJXJXXGX
XJJJJJJXXXJJJJJJJXXXJJJJJJX
XJXJXXJJJJJXXJXXJJJJJXXJXJX
XJXJXXJXJXJXJJJXJXJXJXXJXJX
XJXJJJJXJXJJJJJJJXJXJJJJXJX
XJXJXXJXJXJXJJJXJXJXJXXJXJX
XJXJXXJJJJJXXJXXJJJJJXXJXJX
XJJJJJJXXXJJJJJJJXXXJJJJJJX
XJXXXXJXXXJXXXXXJXXXJXXXXJX
XJJJBXJJJJJJJJJJJJJJJXBJJJX
XJXXJXJXXXXXXXXXXXXXJXJXXJX
XPJJJJJJJJJJJJJJJJJJJJJJJJX
XXXXXXXXXXXXXXXXXXXXXXXXXXX

20
20

XXXXXXXXXXXXXXXXXXXX
XJJJBJJJJJXJJJJJJJJX
XJXXJXXXXJXJXXXXXXJX
XJXXJXJJXJXJXJ2JJXJX
XJJJJXXJXJJJXXXXJJJX
XJXJJJJJXXXXXXXXXXXX
XJXJJJXJX1JJ4JBJJJJX
XJXXXJXPXJJJJXJJJJJX
XJXJJJXJXXXXXXXJXXXX
XJXJXXXJJJJJJJJJJJBX
XJJJJJJJJJXJXJXJXJXX
XXXXXXXXJJJJJJBJXJJX
XBJJJJJJJJXVXVXJXJJX
XXXXXXXXXJJJJJJJJJXX
XJJXJJJJJJJJJJJJJBJX
XJXXVXXJJXXXXJXXXXXX
XJXJJJXJJXVVXJJJJJJX
XJXXXXXJJXXXXJXXXXXX
XJJJJJJJJJJJBJJJJJJX
XXXXXXXXXXXXXXXXXXXX

10
10

XXXXXXXXXX
XBJ1JJXJJX
XJXXXXXJXX
XJJJJ2JJBX
XXXXJXXXJX
XVVVJJBJJX
XPJJJXJVVX
XJXXXXJVVX
XJJJBJJJ4X
XXXXXXXXXX